1111111111111
10011X0000001
10011X0000001
10011X0000001
10X000PCCCEX1
10001X0110001
1111111111111