1111111111111
10011X0000001
10011X0000001
10011X00E0001
10X000PCCC0X1
10001X0110001
1111111111111