11111111111111111111
1110000000P00000E111
111X00000X1001111111
11100000000X0C000111
110000011C1100000111
111000000001XCC00111
1110X111111111111111
111000000XC000000011
11111111000111111111
11111111111111111111